Round,Round Name,Match ID,UTC Time,Home Team,xG_home,home_goals,away_goals,xG_away,Away Team,Attendance,Venue,Referee,Match Outcome,goal_total,xg_goal_total,home_xg_diff,away_xg_diff,home_goal_diff,away_goal_diff,home_pts_earned,away_pts_earned
1,1,4205343,2023-08-11T17:30:00Z,Almeria,1.40,0,2,2.10,Rayo Vallecano,14837,Power Horse Stadium,Javier Alberola,Away Team Wins,2,3.50,-1.40,-0.10,-2,2,0,3
1,1,4205347,2023-08-11T20:00:00Z,Sevilla,0.70,1,2,1.10,Valencia,34184,Estadio Ramón Sánchez Pizjuán,José Sánchez,Away Team Wins,3,1.80,0.30,0.90,-1,1,0,3
1,1,4205351,2023-08-12T15:00:00Z,Real Sociedad,1.00,1,1,0.80,Girona,30848,Reale Arena,Francisco Hernández,Tied Game,2,1.80,0.00,0.20,0,0,1,1
1,1,4205348,2023-08-12T17:30:00Z,Las Palmas,0.90,1,1,1.60,Mallorca,24100,Estadio de Gran Canaria,Víctor García,Tied Game,2,2.50,0.10,-0.60,0,0,1,1
1,1,4205344,2023-08-12T19:30:00Z,Athletic Club,0.40,0,2,0.90,Real Madrid,48927,San Mamés,Jesús Gil,Away Team Wins,2,1.30,-0.40,1.10,-2,2,0,3
1,1,4205346,2023-08-13T15:00:00Z,Celta Vigo,1.00,0,2,1.00,Osasuna,20269,Estadio Abanca Balaídos,Pablo González,Away Team Wins,2,2.00,-1.00,1.00,-2,2,0,3
1,1,4205350,2023-08-13T17:30:00Z,Villarreal,0.90,1,2,1.10,Real Betis,17825,Estadio de la Cerámica,Miguel Ángel Ortiz Arias,Away Team Wins,3,2.00,0.10,0.90,-1,1,0,3
1,1,4205349,2023-08-13T19:30:00Z,Getafe,0.60,0,0,1.40,Barcelona,13410,Coliseum Alfonso Pérez,César Soto,Tied Game,0,2.00,-0.60,-1.40,0,0,1,1
1,1,4205352,2023-08-14T17:30:00Z,Cadiz,0.70,1,0,0.30,Deportivo Alaves,19306,Estadio Nuevo Mirandilla,Isidro Díaz de Mera,Home Team Wins,1,1.00,0.30,-0.30,1,-1,3,0
1,1,4205345,2023-08-14T19:30:00Z,Atletico Madrid,2.40,3,1,0.90,Granada,56164,Estadio Cívitas Metropolitano,Juan Pulido,Home Team Wins,4,3.30,0.60,0.10,2,-2,3,0
2,2,4205355,2023-08-18T17:30:00Z,Mallorca,0.40,0,1,1.80,Villarreal,17775,Estadi Mallorca Son Moix,Javier Alberola,Away Team Wins,1,2.20,-0.40,-0.80,-1,1,0,3
2,2,4205362,2023-08-18T19:30:00Z,Valencia,1.50,1,0,0.50,Las Palmas,41053,Estadio de Mestalla,Javier Villanueva,Home Team Wins,1,2.00,-0.50,-0.50,1,-1,3,0
2,2,4205360,2023-08-19T15:00:00Z,Real Sociedad,0.70,1,1,1.00,Celta Vigo,30354,Reale Arena,Miguel Ángel Ortiz Arias,Tied Game,2,1.70,0.30,0.00,0,0,1,1
2,2,4205353,2023-08-19T17:30:00Z,Almeria,1.30,1,3,2.00,Real Madrid,17561,Power Horse Stadium,José Sánchez,Away Team Wins,4,3.30,-0.30,1.00,-2,2,0,3
2,2,4205358,2023-08-19T19:30:00Z,Osasuna,1.30,0,2,1.50,Athletic Club,20704,Estadio El Sadar,José Luis Munuera,Away Team Wins,2,2.80,-1.30,0.50,-2,2,0,3
2,2,4205361,2023-08-20T17:00:00Z,Girona,1.40,3,0,0.70,Getafe,11784,Estadi Municipal de Montilivi,Jorge Figueroa,Home Team Wins,3,2.10,1.60,-0.70,3,-3,3,0
2,2,4205354,2023-08-20T17:30:00Z,Barcelona,3.40,2,0,1.10,Cadiz,39603,Estadi Olímpic Lluís Companys,Alejandro Muñíz,Home Team Wins,2,4.50,-1.40,-1.10,2,-2,3,0
2,2,4205359,2023-08-20T19:30:00Z,Real Betis,0.70,0,0,0.50,Atletico Madrid,51782,Estadio Benito Villamarín,Ricardo de Burgos,Tied Game,0,1.20,-0.70,-0.50,0,0,1,1
2,2,4205357,2023-08-21T17:00:00Z,Deportivo Alaves,1.80,4,3,0.60,Sevilla,15308,Estadio de Mendizorroza,Guillermo Cuadra,Home Team Wins,7,2.40,2.20,2.40,1,-1,3,0
2,2,4205356,2023-08-21T19:30:00Z,Granada,1.20,0,2,2.10,Rayo Vallecano,17338,Estadio Nuevo Los Cármenes,Pablo González,Away Team Wins,2,3.30,-1.20,-0.10,-2,2,0,3
3,3,4205366,2023-08-25T17:30:00Z,Las Palmas,0.90,0,0,1.00,Real Sociedad,25335,Estadio de Gran Canaria,Guillermo Cuadra,Tied Game,0,1.90,-0.90,-1.00,0,0,1,1
3,3,4205364,2023-08-25T19:30:00Z,Celta Vigo,1.20,0,1,1.40,Real Madrid,23057,Estadio Abanca Balaídos,Isidro Díaz de Mera,Away Team Wins,1,2.60,-1.20,-0.40,-1,1,0,3
3,3,4205367,2023-08-26T17:00:00Z,Cadiz,1.60,1,1,0.30,Almeria,18653,Estadio Nuevo Mirandilla,Víctor García,Tied Game,2,1.90,-0.60,0.70,0,0,1,1
3,3,4205365,2023-08-26T17:30:00Z,Granada,1.40,3,2,2.60,Mallorca,16368,Estadio Nuevo Los Cármenes,Francisco Hernández,Home Team Wins,5,4.00,1.60,-0.60,1,-1,3,0
3,3,4205370,2023-08-26T19:30:00Z,Sevilla,1.70,1,2,1.70,Girona,29304,Estadio Ramón Sánchez Pizjuán,Jesús Gil,Away Team Wins,3,3.40,-0.70,0.30,-1,1,0,3
3,3,4205369,2023-08-27T15:30:00Z,Villarreal,1.90,3,4,3.10,Barcelona,21679,Estadio de la Cerámica,Alejandro Hernández,Away Team Wins,7,5.00,1.10,0.90,-1,1,0,3
3,3,4205371,2023-08-27T17:30:00Z,Valencia,1.70,1,2,1.20,Osasuna,42474,Estadio de Mestalla,Juan Pulido,Away Team Wins,3,2.90,-0.70,0.80,-1,1,0,3
3,3,4205363,2023-08-27T19:30:00Z,Athletic Club,2.90,4,2,0.40,Real Betis,44340,San Mamés,César Soto,Home Team Wins,6,3.30,1.10,1.60,2,-2,3,0
3,3,4205372,2023-08-28T17:30:00Z,Getafe,2.20,1,0,0.70,Deportivo Alaves,11023,Coliseum Alfonso Pérez,Juan Martínez,Home Team Wins,1,2.90,-1.20,-0.70,1,-1,3,0
3,3,4205368,2023-08-28T19:30:00Z,Rayo Vallecano,0.60,0,7,3.40,Atletico Madrid,13966,Estadio del Rayo Vallecano,José Luis Munuera,Away Team Wins,7,4.00,-0.60,3.60,-7,7,0,3
4,4,4205376,2023-09-01T17:30:00Z,Cadiz,2.10,3,1,0.30,Villarreal,18557,Estadio Nuevo Mirandilla,Juan Pulido,Home Team Wins,4,2.40,0.90,0.70,2,-2,3,0
4,4,4205373,2023-09-01T20:00:00Z,Almeria,3.00,2,3,1.50,Celta Vigo,14196,Power Horse Stadium,Ricardo de Burgos,Away Team Wins,5,4.50,-1.00,1.50,-1,1,0,3
4,4,4205382,2023-09-02T12:00:00Z,Real Sociedad,2.30,5,3,0.80,Granada,27808,Reale Arena,Javier Villanueva,Home Team Wins,8,3.10,2.70,2.20,2,-2,3,0
4,4,4205381,2023-09-02T14:15:00Z,Real Madrid,2.80,2,1,0.40,Getafe,66747,Estadio Santiago Bernabéu,Mario Melero,Home Team Wins,3,3.20,-0.80,0.60,1,-1,3,0
4,4,4205378,2023-09-02T16:30:00Z,Deportivo Alaves,1.30,1,0,0.80,Valencia,16641,Estadio de Mendizorroza,Pablo González,Home Team Wins,1,2.10,-0.30,-0.80,1,-1,3,0
4,4,4205375,2023-09-02T19:00:00Z,Real Betis,1.00,1,0,1.50,Rayo Vallecano,50619,Estadio Benito Villamarín,Alejandro Muñíz,Home Team Wins,1,2.50,0.00,-1.50,1,-1,3,0
4,4,4205377,2023-09-03T12:00:00Z,Girona,1.00,1,0,1.10,Las Palmas,11619,Estadi Municipal de Montilivi,Mateo Busquets,Home Team Wins,1,2.10,0.00,-1.10,1,-1,3,0
4,4,4205379,2023-09-03T14:15:00Z,Mallorca,0.40,0,0,0.60,Athletic Club,17043,Estadi Mallorca Son Moix,Jorge Figueroa,Tied Game,0,1.00,-0.40,-0.60,0,0,1,1
4,4,4205380,2023-09-03T19:00:00Z,Osasuna,0.80,1,2,2.00,Barcelona,21966,Estadio El Sadar,Miguel Ángel Ortiz Arias,Away Team Wins,3,2.80,0.20,0.00,-1,1,0,3
5,5,4205392,2023-09-15T19:00:00Z,Rayo Vallecano,2.60,2,0,0.70,Deportivo Alaves,12116,Estadio del Rayo Vallecano,Víctor García,Home Team Wins,2,3.30,-0.60,-0.70,2,-2,3,0
5,5,4205383,2023-09-16T12:00:00Z,Athletic Club,2.90,3,0,0.30,Cadiz,42881,San Mamés,Guillermo Cuadra,Home Team Wins,3,3.20,0.10,-0.30,3,-3,3,0
5,5,4205389,2023-09-16T14:15:00Z,Valencia,1.30,3,0,0.60,Atletico Madrid,45363,Estadio de Mestalla,Jesús Gil,Home Team Wins,3,1.90,1.70,-0.60,3,-3,3,0
5,5,4205385,2023-09-16T16:30:00Z,Celta Vigo,1.30,0,1,0.80,Mallorca,18693,Estadio Abanca Balaídos,José Luis Munuera,Away Team Wins,1,2.10,-1.30,0.20,-1,1,0,3
5,5,4205384,2023-09-16T19:00:00Z,Barcelona,2.40,5,0,0.80,Real Betis,45055,Estadi Olímpic Lluís Companys,José Sánchez,Home Team Wins,5,3.20,2.60,-0.80,5,-5,3,0
5,5,4205386,2023-09-17T12:00:00Z,Getafe,0.50,3,2,1.10,Osasuna,9808,Coliseum Alfonso Pérez,Alejandro Hernández,Home Team Wins,5,1.60,2.50,0.90,1,-1,3,0
5,5,4205388,2023-09-17T14:15:00Z,Villarreal,0.90,2,1,1.50,Almeria,18467,Estadio de la Cerámica,Francisco Hernández,Home Team Wins,3,2.40,1.10,-0.50,1,-1,3,0
5,5,4205391,2023-09-17T16:30:00Z,Sevilla,1.70,1,0,1.00,Las Palmas,40578,Estadio Ramón Sánchez Pizjuán,Juan Martínez,Home Team Wins,1,2.70,-0.70,-1.00,1,-1,3,0
5,5,4205387,2023-09-17T19:00:00Z,Real Madrid,2.00,2,1,1.60,Real Sociedad,70092,Estadio Santiago Bernabéu,César Soto,Home Team Wins,3,3.60,0.00,-0.60,1,-1,3,0
5,5,4205390,2023-09-18T19:00:00Z,Granada,1.60,2,4,2.80,Girona,17323,Estadio Nuevo Los Cármenes,Isidro Díaz de Mera,Away Team Wins,6,4.40,0.40,1.20,-2,2,0,3
6,6,4205400,2023-09-22T19:00:00Z,Deportivo Alaves,1.10,0,2,1.70,Athletic Club,19421,Estadio de Mendizorroza,Alejandro Muñíz,Away Team Wins,2,2.80,-1.10,0.30,-2,2,0,3
6,6,4205397,2023-09-23T12:00:00Z,Girona,3.20,5,3,1.80,Mallorca,11511,Estadi Municipal de Montilivi,Pablo González,Home Team Wins,8,5.00,1.80,1.20,2,-2,3,0
6,6,4205398,2023-09-23T14:15:00Z,Osasuna,1.40,0,0,0.80,Sevilla,19670,Estadio El Sadar,Javier Villanueva,Tied Game,0,2.20,-1.40,-0.80,0,0,1,1
6,6,4205395,2023-09-23T16:30:00Z,Barcelona,1.60,3,2,1.50,Celta Vigo,43272,Estadi Olímpic Lluís Companys,Mario Melero,Home Team Wins,5,3.10,1.40,0.50,1,-1,3,0
6,6,4205393,2023-09-23T19:00:00Z,Almeria,2.60,2,2,0.80,Valencia,14266,Power Horse Stadium,Mateo Busquets,Tied Game,4,3.40,-0.60,1.20,0,0,1,1
6,6,4205401,2023-09-24T12:00:00Z,Real Sociedad,2.00,4,3,1.40,Getafe,29568,Reale Arena,Juan Pulido,Home Team Wins,7,3.40,2.00,1.60,1,-1,3,0
6,6,4205399,2023-09-24T14:15:00Z,Rayo Vallecano,1.20,1,1,1.60,Villarreal,12865,Estadio del Rayo Vallecano,Jorge Figueroa,Tied Game,2,2.80,-0.20,-0.60,0,0,1,1
6,6,4205402,2023-09-24T16:30:00Z,Las Palmas,0.60,1,0,0.00,Granada,24848,Estadio de Gran Canaria,Ricardo de Burgos,Home Team Wins,1,0.60,0.40,0.00,1,-1,3,0
6,6,4205396,2023-09-24T16:30:00Z,Real Betis,1.80,1,1,0.20,Cadiz,56087,Estadio Benito Villamarín,Miguel Ángel Ortiz Arias,Tied Game,2,2.00,-0.80,0.80,0,0,1,1
6,6,4205394,2023-09-24T19:00:00Z,Atletico Madrid,1.40,3,1,1.00,Real Madrid,69082,Estadio Cívitas Metropolitano,Javier Alberola,Home Team Wins,4,2.40,1.60,0.00,2,-2,3,0
7,7,4205405,2023-09-26T17:00:00Z,Sevilla,2.20,5,1,1.80,Almeria,35729,Estadio Ramón Sánchez Pizjuán,Guillermo Cuadra,Home Team Wins,6,4.00,2.80,-0.80,4,-4,3,0
7,7,4205407,2023-09-26T19:30:00Z,Mallorca,0.80,2,2,1.90,Barcelona,19939,Estadi Mallorca Son Moix,Alejandro Muñíz,Tied Game,4,2.70,1.20,0.10,0,0,1,1
7,7,4205403,2023-09-27T17:00:00Z,Athletic Club,0.70,2,2,1.40,Getafe,43091,San Mamés,Isidro Díaz de Mera,Tied Game,4,2.10,1.30,0.60,0,0,1,1
7,7,4205411,2023-09-27T17:00:00Z,Real Madrid,1.70,2,0,0.70,Las Palmas,65017,Estadio Santiago Bernabéu,José Luis Munuera,Home Team Wins,2,2.40,0.30,-0.70,2,-2,3,0
7,7,4205409,2023-09-27T17:00:00Z,Villarreal,1.80,1,2,2.10,Girona,17188,Estadio de la Cerámica,José Sánchez,Away Team Wins,3,3.90,-0.80,-0.10,-1,1,0,3
7,7,4205404,2023-09-27T19:30:00Z,Cadiz,0.60,0,0,0.30,Rayo Vallecano,18505,Estadio Nuevo Mirandilla,Francisco Hernández,Tied Game,0,0.90,-0.60,-0.30,0,0,1,1
7,7,4205410,2023-09-27T19:30:00Z,Valencia,0.40,0,1,0.20,Real Sociedad,44200,Estadio de Mestalla,Alejandro Hernández,Away Team Wins,1,0.60,-0.40,0.80,-1,1,0,3
7,7,4205412,2023-09-28T17:00:00Z,Celta Vigo,0.60,1,1,2.60,Deportivo Alaves,16852,Estadio Abanca Balaídos,César Soto,Tied Game,2,3.20,0.40,-1.60,0,0,1,1
7,7,4205408,2023-09-28T17:00:00Z,Granada,1.80,1,1,0.90,Real Betis,18936,Estadio Nuevo Los Cármenes,Víctor García,Tied Game,2,2.70,-0.80,0.10,0,0,1,1
7,7,4205406,2023-09-28T19:30:00Z,Osasuna,1.00,0,2,1.50,Atletico Madrid,20192,Estadio El Sadar,Juan Martínez,Away Team Wins,2,2.50,-1.00,0.50,-2,2,0,3
8,8,4205415,2023-09-29T19:00:00Z,Barcelona,2.40,1,0,1.10,Sevilla,41116,Estadi Olímpic Lluís Companys,Miguel Ángel Ortiz Arias,Home Team Wins,1,3.50,-1.40,-1.10,1,-1,3,0
8,8,4205417,2023-09-30T12:00:00Z,Getafe,0.90,0,0,0.10,Villarreal,11255,Coliseum Alfonso Pérez,Mateo Busquets,Tied Game,0,1.00,-0.90,-0.10,0,0,1,1
8,8,4205422,2023-09-30T14:15:00Z,Rayo Vallecano,2.30,2,2,1.50,Mallorca,11991,Estadio del Rayo Vallecano,Mario Melero,Tied Game,4,3.80,-0.30,0.50,0,0,1,1
8,8,4205418,2023-09-30T16:30:00Z,Girona,1.60,0,3,2.30,Real Madrid,14184,Estadi Municipal de Montilivi,Juan Pulido,Away Team Wins,3,3.90,-1.60,0.70,-3,3,0,3
8,8,4205420,2023-09-30T19:00:00Z,Real Sociedad,1.40,3,0,1.80,Athletic Club,38229,Reale Arena,Jesús Gil,Home Team Wins,3,3.20,1.60,-1.80,3,-3,3,0
8,8,4205413,2023-10-01T12:00:00Z,Almeria,2.90,3,3,2.90,Granada,14264,Power Horse Stadium,Pablo González,Tied Game,6,5.80,0.10,0.10,0,0,1,1
8,8,4205419,2023-10-01T14:15:00Z,Deportivo Alaves,1.50,0,2,1.10,Osasuna,19035,Estadio de Mendizorroza,Jorge Figueroa,Away Team Wins,2,2.60,-1.50,0.90,-2,2,0,3
8,8,4205414,2023-10-01T19:00:00Z,Atletico Madrid,2.70,3,2,0.80,Cadiz,53421,Estadio Cívitas Metropolitano,Javier Villanueva,Home Team Wins,5,3.50,0.30,1.20,1,-1,3,0
8,8,4205416,2023-10-01T19:00:00Z,Real Betis,1.60,3,0,0.70,Valencia,50163,Estadio Benito Villamarín,Ricardo de Burgos,Home Team Wins,3,2.30,1.40,-0.70,3,-3,3,0
8,8,4205421,2023-10-02T19:00:00Z,Las Palmas,1.70,2,1,1.50,Celta Vigo,22472,Estadio de Gran Canaria,Javier Alberola,Home Team Wins,3,3.20,0.30,-0.50,1,-1,3,0
9,9,4205428,2023-10-06T19:00:00Z,Athletic Club,1.90,3,0,0.10,Almeria,43677,San Mamés,Víctor García,Home Team Wins,3,2.00,1.10,-0.10,3,-3,3,0
9,9,4205424,2023-10-07T12:00:00Z,Cadiz,0.40,0,1,1.20,Girona,16438,Estadio Nuevo Mirandilla,Juan Martínez,Away Team Wins,1,1.60,-0.40,-0.20,-1,1,0,3
9,9,4205430,2023-10-07T14:15:00Z,Real Madrid,3.20,4,0,0.50,Osasuna,70864,Estadio Santiago Bernabéu,Guillermo Cuadra,Home Team Wins,4,3.70,0.80,-0.50,4,-4,3,0
9,9,4205426,2023-10-07T16:30:00Z,Mallorca,0.60,1,1,0.50,Valencia,17659,Estadi Mallorca Son Moix,Francisco Hernández,Tied Game,2,1.10,0.40,0.50,0,0,1,1
9,9,4205431,2023-10-07T19:00:00Z,Sevilla,1.00,2,2,1.00,Rayo Vallecano,35817,Estadio Ramón Sánchez Pizjuán,Isidro Díaz de Mera,Tied Game,4,2.00,1.00,1.00,0,0,1,1
9,9,4205432,2023-10-08T12:00:00Z,Villarreal,1.00,1,2,1.10,Las Palmas,16249,Estadio de la Cerámica,Alejandro Muñíz,Away Team Wins,3,2.10,0.00,0.90,-1,1,0,3
9,9,4205423,2023-10-08T14:15:00Z,Atletico Madrid,2.20,2,1,1.20,Real Sociedad,65607,Estadio Cívitas Metropolitano,José Luis Munuera,Home Team Wins,3,3.40,-0.20,-0.20,1,-1,3,0
9,9,4205425,2023-10-08T16:30:00Z,Celta Vigo,1.30,2,2,0.90,Getafe,18288,Estadio de Mendizorroza,Alejandro Hernández,Tied Game,4,2.20,0.70,1.10,0,0,1,1
9,9,4205427,2023-10-08T16:30:00Z,Deportivo Alaves,3.10,1,1,0.70,Real Betis,17953,Estadio Abanca Balaídos,José Sánchez,Tied Game,2,3.80,-2.10,0.30,0,0,1,1
9,9,4205429,2023-10-08T19:00:00Z,Granada,0.80,2,2,3.00,Barcelona,20354,Estadio Nuevo Los Cármenes,César Soto,Tied Game,4,3.80,1.20,-1.00,0,0,1,1
10,10,4205441,2023-10-20T19:00:00Z,Osasuna,2.10,2,0,0.60,Granada,19739,Estadio El Sadar,Mateo Busquets,Home Team Wins,2,2.70,-0.10,-0.60,2,-2,3,0
10,10,4205439,2023-10-21T12:00:00Z,Real Sociedad,1.30,1,0,1.90,Mallorca,31279,Reale Arena,Jorge Figueroa,Home Team Wins,1,3.20,-0.30,-1.90,1,-1,3,0
10,10,4205437,2023-10-21T14:15:00Z,Getafe,1.50,1,1,1.10,Real Betis,13926,Coliseum Alfonso Pérez,César Soto,Tied Game,2,2.60,-0.50,-0.10,0,0,1,1
10,10,4205440,2023-10-21T16:30:00Z,Sevilla,1.50,1,1,1.60,Real Madrid,41212,Estadio Ramón Sánchez Pizjuán,Ricardo de Burgos,Tied Game,2,3.10,-0.50,-0.60,0,0,1,1
10,10,4205436,2023-10-21T19:00:00Z,Celta Vigo,0.90,0,3,1.80,Atletico Madrid,20282,Estadio Abanca Balaídos,Guillermo Cuadra,Away Team Wins,3,2.70,-0.90,1.20,-3,3,0,3
10,10,4205433,2023-10-22T12:00:00Z,Las Palmas,1.30,0,1,1.40,Rayo Vallecano,24548,Estadio de Gran Canaria,Javier Villanueva,Away Team Wins,1,2.70,-1.30,-0.40,-1,1,0,3
10,10,4205434,2023-10-22T14:15:00Z,Girona,1.90,5,2,1.00,Almeria,12884,Estadi Municipal de Montilivi,Miguel Ángel Ortiz Arias,Home Team Wins,7,2.90,3.10,1.00,3,-3,3,0
10,10,4205442,2023-10-22T16:30:00Z,Villarreal,1.50,1,1,1.70,Deportivo Alaves,17498,Estadio de la Cerámica,Jesús Gil,Tied Game,2,3.20,-0.50,-0.70,0,0,1,1
10,10,4205435,2023-10-22T19:00:00Z,Barcelona,1.30,1,0,0.40,Athletic Club,38194,Estadi Olímpic Lluís Companys,Juan Martínez,Home Team Wins,1,1.70,-0.30,-0.40,1,-1,3,0
10,10,4205438,2023-10-23T19:00:00Z,Valencia,1.50,2,0,0.60,Cadiz,41647,Estadio de Mestalla,Pablo González,Home Team Wins,2,2.10,0.50,-0.60,2,-2,3,0
11,11,4205450,2023-10-27T19:00:00Z,Girona,0.60,1,0,0.20,Celta Vigo,12671,Estadi Municipal de Montilivi,Isidro Díaz de Mera,Home Team Wins,1,0.80,0.40,-0.20,1,-1,3,0
11,11,4205443,2023-10-28T12:00:00Z,Almeria,0.30,1,2,0.90,Las Palmas,12132,Power Horse Stadium,Francisco Hernández,Away Team Wins,3,1.20,0.70,1.10,-1,1,0,3
11,11,4205445,2023-10-28T14:15:00Z,Barcelona,1.50,1,2,1.10,Real Madrid,50112,Estadi Olímpic Lluís Companys,Jesús Gil,Away Team Wins,3,2.60,-0.50,0.90,-1,1,0,3
11,11,4205451,2023-10-28T16:30:00Z,Mallorca,0.90,0,0,0.20,Getafe,15310,Estadi Mallorca Son Moix,Pablo González,Tied Game,0,1.10,-0.90,-0.20,0,0,1,1
11,11,4205447,2023-10-28T19:00:00Z,Cadiz,1.10,2,2,1.20,Sevilla,18886,Estadio Nuevo Mirandilla,César Soto,Tied Game,4,2.30,0.90,0.80,0,0,1,1
11,11,4205446,2023-10-29T13:00:00Z,Real Betis,1.20,2,1,0.40,Osasuna,49123,Estadio Benito Villamarín,José Sánchez,Home Team Wins,3,1.60,0.80,0.60,1,-1,3,0
11,11,4205448,2023-10-29T15:15:00Z,Rayo Vallecano,1.00,2,2,2.00,Real Sociedad,12790,Estadio del Rayo Vallecano,Mateo Busquets,Tied Game,4,3.00,1.00,0.00,0,0,1,1
11,11,4205444,2023-10-29T17:30:00Z,Athletic Club,1.90,2,2,1.90,Valencia,46563,San Mamés,Jorge Figueroa,Tied Game,4,3.80,0.10,0.10,0,0,1,1
11,11,4205452,2023-10-29T20:00:00Z,Atletico Madrid,1.30,2,1,0.50,Deportivo Alaves,50009,Estadio Cívitas Metropolitano,Alejandro Muñíz,Home Team Wins,3,1.80,0.70,0.50,1,-1,3,0
11,11,4205449,2023-10-30T20:00:00Z,Granada,2.10,2,3,1.60,Villarreal,16638,Estadio Nuevo Los Cármenes,Javier Villanueva,Away Team Wins,5,3.70,-0.10,1.40,-1,1,0,3
12,12,4205457,2023-11-03T20:00:00Z,Las Palmas,0.40,2,1,1.20,Atletico Madrid,30080,Estadio de Gran Canaria,Mario Melero,Home Team Wins,3,1.60,1.60,-0.20,1,-1,3,0
12,12,4205460,2023-11-04T13:00:00Z,Osasuna,1.40,2,4,2.20,Girona,20100,Estadio El Sadar,José Luis Munuera,Away Team Wins,6,3.60,0.60,1.80,-2,2,0,3
12,12,4205453,2023-11-04T15:15:00Z,Real Betis,2.20,2,0,0.60,Mallorca,50909,Estadio Benito Villamarín,Miguel Ángel Ortiz Arias,Home Team Wins,2,2.80,-0.20,-0.60,2,-2,3,0
12,12,4205454,2023-11-04T17:30:00Z,Celta Vigo,2.10,1,1,0.90,Sevilla,19023,Estadio Abanca Balaídos,Alejandro Hernández,Tied Game,2,3.00,-1.10,0.10,0,0,1,1
12,12,4205458,2023-11-04T20:00:00Z,Real Sociedad,0.90,0,1,1.20,Barcelona,37555,Reale Arena,Javier Alberola,Away Team Wins,1,2.10,-0.90,-0.20,-1,1,0,3
12,12,4205455,2023-11-05T13:00:00Z,Deportivo Alaves,2.40,1,0,0.50,Almeria,16380,Estadio de Mendizorroza,Juan Pulido,Home Team Wins,1,2.90,-1.40,-0.50,1,-1,3,0
12,12,4205462,2023-11-05T15:15:00Z,Valencia,1.20,1,0,0.50,Granada,44922,Estadio de Mestalla,Víctor García,Home Team Wins,1,1.70,-0.20,-0.50,1,-1,3,0
12,12,4205456,2023-11-05T17:30:00Z,Villarreal,2.10,2,3,2.30,Athletic Club,18709,Estadio de la Cerámica,Guillermo Cuadra,Away Team Wins,5,4.40,-0.10,0.70,-1,1,0,3
12,12,4205461,2023-11-05T20:00:00Z,Real Madrid,2.20,0,0,0.10,Rayo Vallecano,70220,Estadio Santiago Bernabéu,Juan Martínez,Tied Game,0,2.30,-2.20,-0.10,0,0,1,1
12,12,4205459,2023-11-06T20:00:00Z,Getafe,1.20,1,0,0.50,Cadiz,9853,Coliseum Alfonso Pérez,Ricardo de Burgos,Home Team Wins,1,1.70,-0.20,-0.50,1,-1,3,0
13,13,4205464,2023-11-10T20:00:00Z,Athletic Club,4.60,4,3,2.10,Celta Vigo,44435,San Mamés,Juan Pulido,Home Team Wins,7,6.70,-0.60,0.90,1,-1,3,0
13,13,4205470,2023-11-11T13:00:00Z,Rayo Vallecano,1.70,1,2,4.50,Girona,13177,Estadio del Rayo Vallecano,Pablo González,Away Team Wins,3,6.20,-0.70,-2.50,-1,1,0,3
13,13,4205463,2023-11-11T15:15:00Z,Almeria,0.40,1,3,2.40,Real Sociedad,13016,Power Horse Stadium,Isidro Díaz de Mera,Away Team Wins,4,2.80,0.60,0.60,-2,2,0,3
13,13,4205469,2023-11-11T17:30:00Z,Granada,1.00,1,1,0.40,Getafe,20125,Estadio El Sadar,Jorge Figueroa,Tied Game,2,1.40,0.00,0.60,0,0,1,1
13,13,4205471,2023-11-11T17:30:00Z,Osasuna,1.70,1,1,2.30,Las Palmas,18103,Estadio Nuevo Los Cármenes,Alejandro Muñíz,Tied Game,2,4.00,-0.70,-1.30,0,0,1,1
13,13,4205466,2023-11-11T20:00:00Z,Real Madrid,1.70,5,1,1.70,Valencia,72475,Estadio Santiago Bernabéu,José Sánchez,Home Team Wins,6,3.40,3.30,-0.70,4,-4,3,0
13,13,4205472,2023-11-12T15:15:00Z,Barcelona,1.60,2,1,1.70,Deportivo Alaves,38183,Estadi Olímpic Lluís Companys,Mateo Busquets,Home Team Wins,3,3.30,0.40,-0.70,1,-1,3,0
13,13,4205467,2023-11-12T17:30:00Z,Sevilla,0.70,1,1,1.80,Real Betis,42222,Estadio Ramón Sánchez Pizjuán,Jesús Gil,Tied Game,2,2.50,0.30,-0.80,0,0,1,1
13,13,4205465,2023-11-12T20:00:00Z,Atletico Madrid,3.90,3,1,0.80,Villarreal,56632,Estadio Cívitas Metropolitano,Francisco Hernández,Home Team Wins,4,4.70,-0.90,0.20,2,-2,3,0
14,14,4205477,2023-11-24T20:00:00Z,Deportivo Alaves,0.80,3,1,1.10,Granada,15705,Estadio de Mendizorroza,Javier Alberola,Home Team Wins,4,1.90,2.20,-0.10,2,-2,3,0
14,14,4205480,2023-11-25T13:00:00Z,Rayo Vallecano,0.70,1,1,1.00,Barcelona,14148,Estadio del Rayo Vallecano,José Luis Munuera,Tied Game,2,1.70,0.30,0.00,0,0,1,1
14,14,4205481,2023-11-25T15:15:00Z,Valencia,0.50,0,0,0.80,Celta Vigo,43375,Estadio de Mestalla,César Soto,Tied Game,0,1.30,-0.50,-0.80,0,0,1,1
14,14,4205478,2023-11-25T17:30:00Z,Getafe,1.20,2,1,1.80,Almeria,10906,Coliseum Alfonso Pérez,Alejandro Hernández,Home Team Wins,3,3.00,0.80,-0.80,1,-1,3,0
14,14,4205473,2023-11-25T20:00:00Z,Atletico Madrid,1.70,1,0,1.10,Mallorca,58119,Estadio Cívitas Metropolitano,Juan Martínez,Home Team Wins,1,2.80,-0.70,-1.10,1,-1,3,0
14,14,4205482,2023-11-26T13:00:00Z,Villarreal,2.40,3,1,1.00,Osasuna,16389,Estadio de la Cerámica,Ricardo de Burgos,Home Team Wins,4,3.40,0.60,0.00,2,-2,3,0
14,14,4205476,2023-11-26T15:15:00Z,Real Sociedad,0.70,2,1,0.60,Sevilla,33879,Reale Arena,Miguel Ángel Ortiz Arias,Home Team Wins,3,1.30,1.30,0.40,1,-1,3,0
14,14,4205475,2023-11-26T17:30:00Z,Cadiz,1.20,0,3,1.60,Real Madrid,20325,Estadio Nuevo Mirandilla,Guillermo Cuadra,Away Team Wins,3,2.80,-1.20,1.40,-3,3,0,3
14,14,4205474,2023-11-26T20:00:00Z,Real Betis,1.40,1,0,0.60,Las Palmas,48132,Estadio Benito Villamarín,Víctor García,Home Team Wins,1,2.00,-0.40,-0.60,1,-1,3,0
14,14,4205479,2023-11-27T20:00:00Z,Girona,1.30,1,1,1.50,Athletic Club,13123,Estadi Municipal de Montilivi,Mario Melero,Tied Game,2,2.80,-0.30,-0.50,0,0,1,1
13,13,4205468,2023-11-29T20:00:00Z,Mallorca,1.10,1,1,0.30,Cadiz,13821,Estadi Mallorca Son Moix,Javier Villanueva,Tied Game,2,1.40,-0.10,0.70,0,0,1,1
15,15,4205490,2023-12-01T20:00:00Z,Las Palmas,1.50,2,0,0.90,Getafe,21912,Estadio de Gran Canaria,Mateo Busquets,Home Team Wins,2,2.40,0.50,-0.90,2,-2,3,0
15,15,4205485,2023-12-02T13:00:00Z,Girona,1.60,2,1,1.00,Valencia,13343,Estadi Municipal de Montilivi,Javier Villanueva,Home Team Wins,3,2.60,0.40,0.00,1,-1,3,0
15,15,4205484,2023-12-02T15:15:00Z,Athletic Club,1.30,4,0,0.50,Rayo Vallecano,44689,San Mamés,Francisco Hernández,Home Team Wins,4,1.80,2.70,-0.50,4,-4,3,0
15,15,4205491,2023-12-02T17:30:00Z,Real Madrid,1.80,2,0,0.10,Granada,70685,Estadio Santiago Bernabéu,Pablo González,Home Team Wins,2,1.90,0.20,-0.10,2,-2,3,0
15,15,4205486,2023-12-02T20:00:00Z,Osasuna,0.70,1,1,1.70,Real Sociedad,20859,Estadio El Sadar,Juan Pulido,Tied Game,2,2.40,0.30,-0.70,0,0,1,1
15,15,4205492,2023-12-03T13:00:00Z,Mallorca,0.80,0,0,0.30,Deportivo Alaves,15090,Estadi Mallorca Son Moix,Jorge Figueroa,Tied Game,0,1.10,-0.80,-0.30,0,0,1,1
15,15,4205483,2023-12-03T15:15:00Z,Almeria,2.40,0,0,0.50,Real Betis,14253,Power Horse Stadium,Alejandro Muñíz,Tied Game,0,2.90,-2.40,-0.50,0,0,1,1
15,15,4205487,2023-12-03T17:30:00Z,Sevilla,1.80,1,1,1.20,Villarreal,33898,Estadio Ramón Sánchez Pizjuán,Isidro Díaz de Mera,Tied Game,2,3.00,-0.80,-0.20,0,0,1,1
15,15,4205488,2023-12-03T20:00:00Z,Barcelona,2.60,1,0,0.60,Atletico Madrid,34568,Estadi Olímpic Lluís Companys,José Sánchez,Home Team Wins,1,3.20,-1.60,-0.60,1,-1,3,0
15,15,4205489,2023-12-04T20:00:00Z,Celta Vigo,2.40,1,1,0.30,Cadiz,17302,Estadio Abanca Balaídos,Jesús Gil,Tied Game,2,2.70,-1.40,0.70,0,0,1,1
16,16,4205496,2023-12-08T20:00:00Z,Getafe,0.70,1,0,0.10,Valencia,11515,Coliseum Alfonso Pérez,Guillermo Cuadra,Home Team Wins,1,0.80,0.30,-0.10,1,-1,3,0
16,16,4205498,2023-12-09T13:00:00Z,Deportivo Alaves,1.90,0,1,0.40,Las Palmas,15971,Estadio de Mendizorroza,José Luis Munuera,Away Team Wins,1,2.30,-1.90,0.60,-1,1,0,3
16,16,4205494,2023-12-09T15:15:00Z,Real Betis,1.30,1,1,1.00,Real Madrid,52756,Estadio Benito Villamarín,César Soto,Tied Game,2,2.30,-0.30,0.00,0,0,1,1
16,16,4205502,2023-12-09T17:30:00Z,Villarreal,2.20,0,3,1.50,Real Sociedad,19344,Estadio de la Cerámica,Mario Melero,Away Team Wins,3,3.70,-2.20,1.50,-3,3,0,3
16,16,4205497,2023-12-09T20:00:00Z,Mallorca,0.50,1,0,0.60,Sevilla,16041,Estadi Mallorca Son Moix,Javier Alberola,Home Team Wins,1,1.10,0.50,-0.60,1,-1,3,0
16,16,4205499,2023-12-10T13:00:00Z,Atletico Madrid,2.20,2,1,1.30,Almeria,55473,Estadio Cívitas Metropolitano,Ricardo de Burgos,Home Team Wins,3,3.50,-0.20,-0.30,1,-1,3,0
16,16,4205495,2023-12-10T17:30:00Z,Cadiz,0.90,1,1,1.60,Osasuna,18356,Estadio Nuevo Mirandilla,Juan Martínez,Tied Game,2,2.50,0.10,-0.60,0,0,1,1
16,16,4205493,2023-12-10T20:00:00Z,Barcelona,3.70,2,4,2.50,Girona,42848,Estadi Olímpic Lluís Companys,Isidro Díaz de Mera,Away Team Wins,6,6.20,-1.70,1.50,-2,2,0,3
16,16,4205500,2023-12-11T20:00:00Z,Granada,0.70,1,1,1.10,Athletic Club,12849,Estadio Nuevo Los Cármenes,Miguel Ángel Ortiz Arias,Tied Game,2,1.80,0.30,-0.10,0,0,1,1
16,16,4205501,2023-12-11T20:00:00Z,Rayo Vallecano,1.20,0,0,0.10,Celta Vigo,11796,Estadio del Rayo Vallecano,Víctor García,Tied Game,0,1.30,-1.20,-0.10,0,0,1,1
17,17,4205506,2023-12-15T20:00:00Z,Osasuna,1.20,1,0,0.70,Rayo Vallecano,18586,Estadio El Sadar,Javier Villanueva,Home Team Wins,1,1.90,-0.20,-0.70,1,-1,3,0
17,17,4205505,2023-12-16T13:00:00Z,Celta Vigo,1.40,1,0,0.50,Granada,18027,Estadio Abanca Balaídos,José Sánchez,Home Team Wins,1,1.90,-0.40,-0.50,1,-1,3,0
17,17,4205504,2023-12-16T15:15:00Z,Athletic Club,2.40,2,0,0.40,Atletico Madrid,48781,San Mamés,Jesús Gil,Home Team Wins,2,2.80,-0.40,-0.40,2,-2,3,0
17,17,4205511,2023-12-16T17:30:00Z,Sevilla,1.00,0,3,2.40,Getafe,30005,Estadio Ramón Sánchez Pizjuán,Juan Pulido,Away Team Wins,3,3.40,-1.00,0.60,-3,3,0,3
17,17,4205508,2023-12-16T20:00:00Z,Valencia,0.50,1,1,3.20,Barcelona,46492,Estadio de Mestalla,Miguel Ángel Ortiz Arias,Tied Game,2,3.70,0.50,-2.20,0,0,1,1
17,17,4205503,2023-12-17T13:00:00Z,Almeria,0.30,0,0,1.90,Mallorca,11936,Power Horse Stadium,Pablo González,Tied Game,0,2.20,-0.30,-1.90,0,0,1,1
17,17,4205509,2023-12-17T15:15:00Z,Real Sociedad,1.10,0,0,1.10,Real Betis,33172,Reale Arena,Mateo Busquets,Tied Game,0,2.20,-1.10,-1.10,0,0,1,1
17,17,4205510,2023-12-17T17:30:00Z,Las Palmas,0.70,1,1,1.60,Cadiz,25275,Estadio de Gran Canaria,Alejandro Muñíz,Tied Game,2,2.30,0.30,-0.60,0,0,1,1
17,17,4205507,2023-12-17T20:00:00Z,Real Madrid,2.30,4,1,0.80,Villarreal,70500,Estadio Santiago Bernabéu,Jorge Figueroa,Home Team Wins,5,3.10,1.70,0.20,3,-3,3,0
17,17,4205512,2023-12-18T20:00:00Z,Girona,1.70,3,0,0.70,Deportivo Alaves,11812,Estadi Municipal de Montilivi,Francisco Hernández,Home Team Wins,3,2.40,1.30,-0.70,3,-3,3,0
18,18,4205518,2023-12-19T18:00:00Z,Rayo Vallecano,0.30,0,1,0.30,Valencia,12290,Estadio del Rayo Vallecano,Javier Alberola,Away Team Wins,1,0.60,-0.30,0.70,-1,1,0,3
18,18,4205514,2023-12-19T20:30:00Z,Atletico Madrid,2.00,3,3,2.00,Getafe,46401,Estadio Cívitas Metropolitano,José Luis Munuera,Tied Game,6,4.00,1.00,1.00,0,0,1,1
18,18,4205519,2023-12-19T20:30:00Z,Granada,0.90,0,3,0.50,Sevilla,16534,Estadio Nuevo Los Cármenes,Mateo Busquets,Away Team Wins,3,1.40,-0.90,2.50,-3,3,0,3
18,18,4205521,2023-12-20T18:00:00Z,Barcelona,3.40,3,2,1.60,Almeria,34471,Estadi Olímpic Lluís Companys,Guillermo Cuadra,Home Team Wins,5,5.00,-0.40,0.40,1,-1,3,0
18,18,4205513,2023-12-20T20:30:00Z,Athletic Club,3.40,1,0,0.30,Las Palmas,39471,San Mamés,Juan Martínez,Home Team Wins,1,3.70,-2.40,-0.30,1,-1,3,0
18,18,4205522,2023-12-20T20:30:00Z,Villarreal,2.40,3,2,1.30,Celta Vigo,14687,Estadio de la Cerámica,César Soto,Home Team Wins,5,3.70,0.60,0.70,1,-1,3,0
18,18,4205516,2023-12-21T18:00:00Z,Cadiz,1.00,0,0,0.50,Real Sociedad,17693,Estadio Nuevo Mirandilla,Javier Villanueva,Tied Game,0,1.50,-1.00,-0.50,0,0,1,1
18,18,4205515,2023-12-21T18:00:00Z,Real Betis,1.50,1,1,1.70,Girona,51394,Estadio Benito Villamarín,Ricardo de Burgos,Tied Game,2,3.20,-0.50,-0.70,0,0,1,1
18,18,4205520,2023-12-21T20:30:00Z,Deportivo Alaves,0.60,0,1,0.60,Real Madrid,19275,Estadio de Mendizorroza,Isidro Díaz de Mera,Away Team Wins,1,1.20,-0.60,0.40,-1,1,0,3
18,18,4205517,2023-12-21T20:30:00Z,Mallorca,1.10,3,2,1.60,Osasuna,14192,Estadi Mallorca Son Moix,Mario Melero,Home Team Wins,5,2.70,1.90,0.40,1,-1,3,0
4,4,4205374,2023-12-23T15:15:00Z,Atletico Madrid,0.90,1,0,0.30,Sevilla,64308,Estadio Cívitas Metropolitano,César Soto,Home Team Wins,1,1.20,0.10,-0.30,1,-1,3,0
19,19,4205523,2024-01-02T16:00:00Z,Getafe,0.40,0,2,1.90,Rayo Vallecano,11204,Estadio Cívitas Metropolitano,Jorge Figueroa,Away Team Wins,2,2.30,-0.40,0.10,-2,2,0,3
19,19,4205532,2024-01-02T18:15:00Z,Real Sociedad,1.20,1,1,1.00,Deportivo Alaves,34051,Reale Arena,Víctor García,Tied Game,2,2.20,-0.20,0.00,0,0,1,1
19,19,4205524,2024-01-02T20:30:00Z,Valencia,2.80,3,1,0.50,Villarreal,44973,Estadio de Mestalla,Jesús Gil,Home Team Wins,4,3.30,0.20,0.50,2,-2,3,0
19,19,4205530,2024-01-03T16:00:00Z,Granada,3.00,2,0,0.80,Cadiz,17732,Estadio Nuevo Los Cármenes,Juan Pulido,Home Team Wins,2,3.80,-1.00,-0.80,2,-2,3,0
19,19,4205529,2024-01-03T18:15:00Z,Celta Vigo,1.70,2,1,0.60,Real Betis,72394,Estadio Santiago Bernabéu,Alejandro Muñíz,Home Team Wins,3,2.30,0.30,0.40,1,-1,3,0
19,19,4205531,2024-01-03T18:15:00Z,Real Madrid,2.70,1,0,1.40,Mallorca,21105,Estadio Abanca Balaídos,Miguel Ángel Ortiz Arias,Home Team Wins,1,4.10,-1.70,-1.40,1,-1,3,0
19,19,4205527,2024-01-03T20:30:00Z,Girona,2.30,4,3,2.30,Atletico Madrid,13804,Estadi Municipal de Montilivi,Alejandro Hernández,Home Team Wins,7,4.60,1.70,0.70,1,-1,3,0
19,19,4205525,2024-01-04T16:00:00Z,Osasuna,1.30,1,0,0.20,Almeria,20391,Estadio El Sadar,César Soto,Home Team Wins,1,1.50,-0.30,-0.20,1,-1,3,0
19,19,4205526,2024-01-04T18:15:00Z,Sevilla,0.70,0,2,1.30,Athletic Club,28366,Estadio Ramón Sánchez Pizjuán,José Sánchez,Away Team Wins,2,2.00,-0.70,0.70,-2,2,0,3
19,19,4205528,2024-01-04T20:30:00Z,Las Palmas,0.70,1,2,2.40,Barcelona,31712,Estadio de Gran Canaria,Pablo González,Away Team Wins,3,3.10,0.30,-0.40,-1,1,0,3
20,20,4205542,2024-01-12T20:00:00Z,Sevilla,2.20,2,3,2.00,Deportivo Alaves,34225,Estadio Ramón Sánchez Pizjuán,Alejandro Hernández,Away Team Wins,5,4.20,-0.20,1.00,-1,1,0,3
20,20,4205540,2024-01-13T13:05:00Z,Las Palmas,0.80,3,0,2.00,Villarreal,24485,Estadio de Gran Canaria,Javier Villanueva,Home Team Wins,3,2.80,2.20,-2.00,3,-3,3,0
20,20,4205541,2024-01-13T15:15:00Z,Mallorca,1.80,1,1,0.60,Celta Vigo,21130,Estadi Mallorca Son Moix,Víctor García,Tied Game,2,2.40,-0.80,0.40,0,0,1,1
20,20,4205534,2024-01-13T17:30:00Z,Athletic Club,1.60,2,1,1.10,Real Sociedad,51475,San Mamés,José Luis Munuera,Home Team Wins,3,2.70,0.40,-0.10,1,-1,3,0
20,20,4205537,2024-01-13T20:00:00Z,Real Betis,1.80,1,0,0.50,Granada,50197,Estadio Benito Villamarín,Guillermo Cuadra,Home Team Wins,1,2.30,-0.80,-0.50,1,-1,3,0
20,20,4205533,2024-01-14T13:00:00Z,Almeria,1.70,0,0,0.30,Girona,12111,Power Horse Stadium,Mateo Busquets,Tied Game,0,2.00,-1.70,-0.30,0,0,1,1
20,20,4205538,2024-01-14T15:15:00Z,Cadiz,1.10,1,4,1.90,Valencia,18622,Estadio Nuevo Mirandilla,Isidro Díaz de Mera,Away Team Wins,5,3.00,-0.10,2.10,-3,3,0,3
21,21,4205545,2024-01-19T20:00:00Z,Deportivo Alaves,2.00,1,0,0.30,Cadiz,15838,Estadio de Mendizorroza,Alejandro Muñíz,Home Team Wins,1,2.30,-1.00,-0.30,1,-1,3,0
21,21,4205552,2024-01-20T13:00:00Z,Rayo Vallecano,1.60,0,2,0.70,Las Palmas,12477,Estadio del Rayo Vallecano,Mario Melero,Away Team Wins,2,2.30,-1.60,1.30,-2,2,0,3
21,21,4205551,2024-01-20T15:15:00Z,Villarreal,1.90,1,1,0.40,Mallorca,16479,Estadio de la Cerámica,Miguel Ángel Ortiz Arias,Tied Game,2,2.30,-0.90,0.60,0,0,1,1
21,21,4205547,2024-01-20T17:30:00Z,Valencia,0.90,1,0,0.50,Athletic Club,45344,Estadio de Mestalla,Juan Pulido,Home Team Wins,1,1.40,0.10,-0.50,1,-1,3,0
21,21,4205543,2024-01-20T20:00:00Z,Celta Vigo,0.30,0,1,0.80,Real Sociedad,20901,Estadio Abanca Balaídos,Jorge Figueroa,Away Team Wins,1,1.10,-0.30,0.20,-1,1,0,3
21,21,4205550,2024-01-21T13:00:00Z,Osasuna,1.20,3,2,1.40,Getafe,18811,Estadio El Sadar,José Sánchez,Home Team Wins,5,2.60,1.80,0.60,1,-1,3,0
21,21,4205546,2024-01-21T15:15:00Z,Real Madrid,2.20,3,2,0.90,Almeria,72044,Estadio Santiago Bernabéu,Francisco Hernández,Home Team Wins,5,3.10,0.80,1.10,1,-1,3,0
21,21,4205549,2024-01-21T17:30:00Z,Real Betis,1.10,2,4,3.00,Barcelona,53288,Estadio Benito Villamarín,Jesús Gil,Away Team Wins,6,4.10,0.90,1.00,-2,2,0,3
21,21,4205544,2024-01-21T20:00:00Z,Girona,2.30,5,1,0.70,Sevilla,13092,Estadi Municipal de Montilivi,Pablo González,Home Team Wins,6,3.00,2.70,0.30,4,-4,3,0
21,21,4205548,2024-01-22T20:00:00Z,Granada,0.60,0,1,1.20,Atletico Madrid,18704,Estadio Nuevo Los Cármenes,Juan Martínez,Away Team Wins,1,1.80,-0.60,-0.20,-1,1,0,3
22,22,4205562,2024-01-26T20:00:00Z,Almeria,1.40,0,3,1.80,Deportivo Alaves,13817,Power Horse Stadium,Miguel Ángel Ortiz Arias,Away Team Wins,3,3.20,-1.40,1.20,-3,3,0,3
22,22,4205561,2024-01-27T13:00:00Z,Real Sociedad,0.20,0,0,0.10,Rayo Vallecano,32528,Reale Arena,Alejandro Hernández,Tied Game,0,0.30,-0.20,-0.10,0,0,1,1
22,22,4205557,2024-01-27T15:15:00Z,Las Palmas,0.70,1,2,2.30,Real Madrid,32037,Estadio de Gran Canaria,César Soto,Away Team Wins,3,3.00,0.30,-0.30,-1,1,0,3
22,22,4205554,2024-01-27T17:30:00Z,Barcelona,2.20,3,5,2.10,Villarreal,46229,Estadi Olímpic Lluís Companys,José Luis Munuera,Away Team Wins,8,4.30,0.80,2.90,-2,2,0,3
22,22,4205559,2024-01-27T20:00:00Z,Mallorca,1.50,0,1,0.40,Real Betis,20051,Estadi Mallorca Son Moix,Javier Villanueva,Away Team Wins,1,1.90,-1.50,0.60,-1,1,0,3
22,22,4205555,2024-01-28T13:00:00Z,Celta Vigo,0.60,0,1,0.90,Girona,20684,Estadio Abanca Balaídos,Mario Melero,Away Team Wins,1,1.50,-0.60,0.10,-1,1,0,3
22,22,4205558,2024-01-28T15:15:00Z,Cadiz,0.40,0,0,0.20,Athletic Club,18839,Estadio Nuevo Mirandilla,Mateo Busquets,Tied Game,0,0.60,-0.40,-0.20,0,0,1,1
22,22,4205560,2024-01-28T17:30:00Z,Sevilla,0.80,1,1,1.20,Osasuna,36640,Estadio Ramón Sánchez Pizjuán,Guillermo Cuadra,Tied Game,2,2.00,0.20,-0.20,0,0,1,1
22,22,4205553,2024-01-28T20:00:00Z,Atletico Madrid,2.40,2,0,0.50,Valencia,59493,Estadio Cívitas Metropolitano,Ricardo de Burgos,Home Team Wins,2,2.90,-0.40,-0.50,2,-2,3,0
22,22,4205556,2024-01-29T20:00:00Z,Getafe,1.30,2,0,1.90,Granada,10382,Coliseum Alfonso Pérez,Víctor García,Home Team Wins,2,3.20,0.70,-1.90,2,-2,3,0
20,20,4205536,2024-01-31T18:00:00Z,Barcelona,1.90,1,0,1.00,Osasuna,37888,Estadi Olímpic Lluís Companys,Jorge Figueroa,Home Team Wins,1,2.90,-0.90,-1.00,1,-1,3,0
20,20,4205535,2024-01-31T20:00:00Z,Atletico Madrid,1.00,2,1,0.40,Rayo Vallecano,47003,Estadio Cívitas Metropolitano,César Soto,Home Team Wins,3,1.40,1.00,0.60,1,-1,3,0
20,20,4205539,2024-02-01T20:00:00Z,Getafe,0.80,0,2,2.00,Real Madrid,15264,Coliseum Alfonso Pérez,Ricardo de Burgos,Away Team Wins,2,2.80,-0.80,0.00,-2,2,0,3
23,23,4205563,2024-02-02T20:00:00Z,Athletic Club,1.70,4,0,0.40,Mallorca,47061,San Mamés,Jorge Figueroa,Home Team Wins,4,2.10,2.30,-0.40,4,-4,3,0
23,23,4205569,2024-02-03T13:00:00Z,Valencia,1.40,2,1,1.90,Almeria,42877,Estadio de Mestalla,Alejandro Muñíz,Home Team Wins,3,3.30,0.60,-0.90,1,-1,3,0
23,23,4205567,2024-02-03T15:15:00Z,Granada,0.10,1,1,1.00,Las Palmas,17941,Estadio Nuevo Los Cármenes,Mateo Busquets,Tied Game,2,1.10,0.90,0.00,0,0,1,1
23,23,4205568,2024-02-03T17:30:00Z,Deportivo Alaves,1.00,1,3,1.20,Barcelona,19480,Estadio de Mendizorroza,Juan Martínez,Away Team Wins,4,2.20,0.00,1.80,-2,2,0,3
23,23,4205565,2024-02-03T20:00:00Z,Girona,0.70,0,0,0.60,Real Sociedad,13755,Estadi Municipal de Montilivi,Jesús Gil,Tied Game,0,1.30,-0.70,-0.60,0,0,1,1
23,23,4205571,2024-02-04T13:00:00Z,Villarreal,1.20,0,0,0.70,Cadiz,17183,Estadio de la Cerámica,Pablo González,Tied Game,0,1.90,-1.20,-0.70,0,0,1,1
23,23,4205572,2024-02-04T15:15:00Z,Osasuna,1.10,0,3,1.10,Celta Vigo,20030,Estadio El Sadar,Javier Alberola,Away Team Wins,3,2.20,-1.10,1.90,-3,3,0,3
23,23,4205564,2024-02-04T17:30:00Z,Real Betis,1.60,1,1,1.50,Getafe,53336,Estadio Benito Villamarín,Juan Pulido,Tied Game,2,3.10,-0.60,-0.50,0,0,1,1
23,23,4205570,2024-02-04T20:00:00Z,Real Madrid,1.90,1,1,1.10,Atletico Madrid,76732,Estadio Santiago Bernabéu,José Sánchez,Tied Game,2,3.00,-0.90,-0.10,0,0,1,1
23,23,4205566,2024-02-05T20:00:00Z,Rayo Vallecano,1.80,1,2,1.30,Sevilla,12546,Estadio del Rayo Vallecano,Francisco Hernández,Away Team Wins,3,3.10,-0.80,0.70,-1,1,0,3
24,24,4205579,2024-02-09T20:00:00Z,Cadiz,0.80,0,2,1.00,Real Betis,15346,Estadio Nuevo Mirandilla,Ricardo de Burgos,Away Team Wins,2,1.80,-0.80,1.00,-2,2,0,3
24,24,4205577,2024-02-10T13:00:00Z,Deportivo Alaves,1.80,1,1,1.20,Villarreal,14523,Estadio de Mendizorroza,Mario Melero,Tied Game,2,3.00,-0.80,-0.20,0,0,1,1
24,24,4205582,2024-02-10T15:15:00Z,Real Sociedad,1.50,0,1,0.50,Osasuna,32905,Reale Arena,Isidro Díaz de Mera,Away Team Wins,1,2.00,-1.50,0.50,-1,1,0,3
24,24,4205581,2024-02-10T17:30:00Z,Real Madrid,3.20,4,0,0.30,Girona,76585,Estadio Santiago Bernabéu,Juan Martínez,Home Team Wins,4,3.50,0.80,-0.30,4,-4,3,0
24,24,4205576,2024-02-10T20:00:00Z,Las Palmas,1.30,2,0,0.50,Valencia,25633,Estadio de Gran Canaria,Guillermo Cuadra,Home Team Wins,2,1.80,0.70,-0.50,2,-2,3,0
24,24,4205580,2024-02-11T13:00:00Z,Getafe,2.10,3,2,1.20,Celta Vigo,11502,Coliseum Alfonso Pérez,Alejandro Hernández,Home Team Wins,5,3.30,0.90,0.80,1,-1,3,0
24,24,4205575,2024-02-11T15:15:00Z,Mallorca,0.90,2,1,1.60,Rayo Vallecano,16735,Estadi Mallorca Son Moix,José Luis Munuera,Home Team Wins,3,2.50,1.10,-0.60,1,-1,3,0
24,24,4205578,2024-02-11T17:30:00Z,Sevilla,1.00,1,0,1.50,Atletico Madrid,31528,Estadio Ramón Sánchez Pizjuán,Javier Villanueva,Home Team Wins,1,2.50,0.00,-1.50,1,-1,3,0
24,24,4205574,2024-02-11T20:00:00Z,Barcelona,2.30,3,3,1.40,Granada,41901,Estadi Olímpic Lluís Companys,Miguel Ángel Ortiz Arias,Tied Game,6,3.70,0.70,1.60,0,0,1,1
24,24,4205573,2024-02-12T20:00:00Z,Almeria,0.90,0,0,0.70,Athletic Club,12863,Power Horse Stadium,Víctor García,Tied Game,0,1.60,-0.90,-0.70,0,0,1,1
25,25,4205590,2024-02-16T20:00:00Z,Villarreal,1.20,1,1,0.80,Getafe,16869,Estadio de la Cerámica,Javier Alberola,Tied Game,2,2.00,-0.20,0.20,0,0,1,1
25,25,4205584,2024-02-17T13:00:00Z,Atletico Madrid,3.50,5,0,0.70,Las Palmas,61196,Estadio Cívitas Metropolitano,Jorge Figueroa,Home Team Wins,5,4.20,1.50,-0.70,5,-5,3,0
25,25,4205589,2024-02-17T15:15:00Z,Osasuna,2.00,2,0,0.50,Cadiz,19525,Estadio El Sadar,Francisco Hernández,Home Team Wins,2,2.50,0.00,-0.50,2,-2,3,0
25,25,4205588,2024-02-17T17:30:00Z,Celta Vigo,0.80,1,2,1.50,Barcelona,23096,Estadio Abanca Balaídos,Juan Pulido,Away Team Wins,3,2.30,0.20,0.50,-1,1,0,3
25,25,4205591,2024-02-17T20:00:00Z,Valencia,1.00,0,0,0.00,Sevilla,44506,Estadio de Mestalla,César Soto,Tied Game,0,1.00,-1.00,0.00,0,0,1,1
25,25,4205586,2024-02-18T13:00:00Z,Rayo Vallecano,1.10,1,1,1.10,Real Madrid,14354,Estadio del Rayo Vallecano,Alejandro Muñíz,Tied Game,2,2.20,-0.10,-0.10,0,0,1,1
25,25,4205587,2024-02-18T15:15:00Z,Granada,2.00,1,1,1.40,Almeria,18756,Estadio Nuevo Los Cármenes,Jesús Gil,Tied Game,2,3.40,-1.00,-0.40,0,0,1,1
25,25,4205585,2024-02-18T17:30:00Z,Mallorca,0.10,1,2,1.10,Real Sociedad,18153,Estadi Mallorca Son Moix,Pablo González,Away Team Wins,3,1.20,0.90,0.90,-1,1,0,3
25,25,4205592,2024-02-18T20:00:00Z,Real Betis,0.80,0,0,0.50,Deportivo Alaves,43514,Estadio Benito Villamarín,Mateo Busquets,Tied Game,0,1.30,-0.80,-0.50,0,0,1,1
25,25,4205583,2024-02-19T20:00:00Z,Athletic Club,1.80,3,2,2.10,Girona,46220,San Mamés,José Sánchez,Home Team Wins,5,3.90,1.20,-0.10,1,-1,3,0
26,26,4205598,2024-02-23T20:00:00Z,Real Sociedad,1.50,1,3,1.00,Villarreal,30609,Reale Arena,Javier Villanueva,Away Team Wins,4,2.50,-0.50,2.00,-2,2,0,3
26,26,4205594,2024-02-24T15:15:00Z,Barcelona,3.10,4,0,0.50,Getafe,36803,Estadi Olímpic Lluís Companys,Alejandro Muñíz,Home Team Wins,4,3.60,0.90,-0.50,4,-4,3,0
26,26,4205601,2024-02-24T17:30:00Z,Deportivo Alaves,0.50,1,1,2.20,Mallorca,16102,Estadio de Mendizorroza,Víctor García,Tied Game,2,2.70,0.50,-1.20,0,0,1,1
26,26,4205593,2024-02-24T20:00:00Z,Almeria,0.50,2,2,1.50,Atletico Madrid,14472,Power Horse Stadium,Javier Alberola,Tied Game,4,2.00,1.50,0.50,0,0,1,1
26,26,4205595,2024-02-25T13:00:00Z,Cadiz,2.20,2,2,0.70,Celta Vigo,18123,Estadio Nuevo Mirandilla,Miguel Ángel Ortiz Arias,Tied Game,4,2.90,-0.20,1.30,0,0,1,1
26,26,4205602,2024-02-25T15:15:00Z,Real Betis,1.20,3,1,0.20,Athletic Club,53537,Estadio Benito Villamarín,Guillermo Cuadra,Home Team Wins,4,1.40,1.80,0.80,2,-2,3,0
26,26,4205600,2024-02-25T17:30:00Z,Las Palmas,0.70,1,1,0.70,Osasuna,25075,Estadio de Gran Canaria,José Luis Munuera,Tied Game,2,1.40,0.30,0.30,0,0,1,1
26,26,4205597,2024-02-25T20:00:00Z,Real Madrid,1.00,1,0,0.80,Sevilla,74969,Estadio Santiago Bernabéu,Isidro Díaz de Mera,Home Team Wins,1,1.80,0.00,-0.80,1,-1,3,0
26,26,4205596,2024-02-26T20:00:00Z,Girona,2.20,3,0,0.50,Rayo Vallecano,8923,Estadi Municipal de Montilivi,Ricardo de Burgos,Home Team Wins,3,2.70,0.80,-0.50,3,-3,3,0
27,27,4205606,2024-03-01T20:00:00Z,Celta Vigo,1.50,1,0,0.10,Almeria,18005,Estadio Abanca Balaídos,José Sánchez,Home Team Wins,1,1.60,-0.50,-0.10,1,-1,3,0
27,27,4205610,2024-03-02T13:00:00Z,Sevilla,2.00,3,2,1.50,Real Sociedad,35884,Estadio Ramón Sánchez Pizjuán,Mateo Busquets,Home Team Wins,5,3.50,1.00,0.50,1,-1,3,0
27,27,4205607,2024-03-02T15:15:00Z,Rayo Vallecano,0.70,1,1,1.00,Cadiz,12272,Estadio del Rayo Vallecano,Javier Alberola,Tied Game,2,1.70,0.30,0.00,0,0,1,1
27,27,4205605,2024-03-02T17:30:00Z,Getafe,2.30,3,3,1.60,Las Palmas,7623,Coliseum Alfonso Pérez,Pablo González,Tied Game,6,3.90,0.70,1.40,0,0,1,1
27,27,4205609,2024-03-02T20:00:00Z,Valencia,1.10,2,2,2.20,Real Madrid,47427,Estadio de Mestalla,Jesús Gil,Tied Game,4,3.30,0.90,-0.20,0,0,1,1
27,27,4205611,2024-03-03T13:00:00Z,Villarreal,2.00,5,1,0.50,Granada,15896,Estadio de la Cerámica,Juan Pulido,Home Team Wins,6,2.50,3.00,0.50,4,-4,3,0
27,27,4205604,2024-03-03T15:15:00Z,Atletico Madrid,3.00,2,1,0.60,Real Betis,61901,Estadio Cívitas Metropolitano,César Soto,Home Team Wins,3,3.60,-1.00,0.40,1,-1,3,0
27,27,4205608,2024-03-03T17:30:00Z,Mallorca,1.20,1,0,1.00,Girona,17769,Estadi Mallorca Son Moix,Francisco Hernández,Home Team Wins,1,2.20,-0.20,-1.00,1,-1,3,0
27,27,4205603,2024-03-03T20:00:00Z,Athletic Club,0.40,0,0,0.70,Barcelona,50295,San Mamés,Alejandro Hernández,Tied Game,0,1.10,-0.40,-0.70,0,0,1,1
27,27,4205612,2024-03-04T20:00:00Z,Osasuna,1.00,1,0,1.00,Deportivo Alaves,17215,Estadio El Sadar,Jorge Figueroa,Home Team Wins,1,2.00,0.00,-1.00,1,-1,3,0
28,28,4205614,2024-03-08T20:00:00Z,Barcelona,2.00,1,0,0.60,Mallorca,38225,Estadi Olímpic Lluís Companys,Javier Villanueva,Home Team Wins,1,2.60,-1.00,-0.60,1,-1,3,0
28,28,4205622,2024-03-09T13:00:00Z,Valencia,0.80,1,0,1.30,Getafe,37961,Estadio de Mestalla,Juan Pulido,Home Team Wins,1,2.10,0.20,-1.30,1,-1,3,0
28,28,4205620,2024-03-09T15:15:00Z,Cadiz,1.10,2,0,0.90,Atletico Madrid,15917,Estadio Nuevo Mirandilla,Pablo González,Home Team Wins,2,2.00,0.90,-0.90,2,-2,3,0
28,28,4205617,2024-03-09T17:30:00Z,Granada,1.70,2,3,2.10,Real Sociedad,9214,Estadio Nuevo Los Cármenes,Juan Martínez,Away Team Wins,5,3.80,0.30,0.90,-1,1,0,3
28,28,4205616,2024-03-09T20:00:00Z,Girona,1.90,2,0,0.20,Osasuna,11598,Estadi Municipal de Montilivi,Mateo Busquets,Home Team Wins,2,2.10,0.10,-0.20,2,-2,3,0
28,28,4205618,2024-03-10T13:00:00Z,Deportivo Alaves,0.60,1,0,0.60,Rayo Vallecano,16519,Estadio de Mendizorroza,José Luis Munuera,Home Team Wins,1,1.20,0.40,-0.60,1,-1,3,0
28,28,4205619,2024-03-10T15:15:00Z,Las Palmas,1.20,0,2,1.10,Athletic Club,27316,Estadio de Gran Canaria,Miguel Ángel Ortiz Arias,Away Team Wins,2,2.30,-1.20,0.90,-2,2,0,3
28,28,4205621,2024-03-10T17:30:00Z,Real Madrid,3.40,4,0,0.80,Celta Vigo,73644,Estadio Santiago Bernabéu,Mario Melero,Home Team Wins,4,4.20,0.60,-0.80,4,-4,3,0
28,28,4205615,2024-03-10T20:00:00Z,Real Betis,1.00,2,3,1.40,Villarreal,47711,Estadio Benito Villamarín,Alejandro Hernández,Away Team Wins,5,2.40,1.00,1.60,-1,1,0,3
28,28,4205613,2024-03-11T20:00:00Z,Almeria,2.00,2,2,2.40,Sevilla,13095,Power Horse Stadium,Ricardo de Burgos,Tied Game,4,4.40,0.00,-0.40,0,0,1,1
29,29,4205628,2024-03-15T20:00:00Z,Real Sociedad,1.90,2,0,0.80,Cadiz,31000,Reale Arena,César Soto,Home Team Wins,2,2.70,0.10,-0.80,2,-2,3,0
29,29,4205631,2024-03-16T13:00:00Z,Mallorca,1.60,1,0,0.40,Granada,16477,Estadi Mallorca Son Moix,Ricardo de Burgos,Home Team Wins,1,2.00,-0.60,-0.40,1,-1,3,0
29,29,4205625,2024-03-16T15:15:00Z,Osasuna,0.70,2,4,2.90,Real Madrid,22430,Estadio El Sadar,Juan Martínez,Away Team Wins,6,3.60,1.30,1.10,-2,2,0,3
29,29,4205624,2024-03-16T17:30:00Z,Getafe,1.20,1,0,1.80,Girona,12912,Coliseum Alfonso Pérez,José Luis Munuera,Home Team Wins,1,3.00,-0.20,-1.80,1,-1,3,0
29,29,4205632,2024-03-16T20:00:00Z,Athletic Club,1.70,2,0,1.30,Deportivo Alaves,48257,San Mamés,Alejandro Muñíz,Home Team Wins,2,3.00,0.30,-1.30,2,-2,3,0
29,29,4205629,2024-03-17T13:00:00Z,Sevilla,1.70,1,2,1.60,Celta Vigo,36544,Estadio Ramón Sánchez Pizjuán,Francisco Hernández,Away Team Wins,3,3.30,-0.70,0.40,-1,1,0,3
29,29,4205626,2024-03-17T15:15:00Z,Las Palmas,0.90,0,1,0.80,Almeria,22865,Estadio de Gran Canaria,Víctor García,Away Team Wins,1,1.70,-0.90,0.20,-1,1,0,3
29,29,4205630,2024-03-17T15:15:00Z,Villarreal,2.00,1,0,1.10,Valencia,20647,Estadio de la Cerámica,Jorge Figueroa,Home Team Wins,1,3.10,-1.00,-1.10,1,-1,3,0
29,29,4205627,2024-03-17T17:30:00Z,Rayo Vallecano,0.70,2,0,0.80,Real Betis,13264,Estadio del Rayo Vallecano,Juan Pulido,Home Team Wins,2,1.50,1.30,-0.80,2,-2,3,0
29,29,4205623,2024-03-17T20:00:00Z,Atletico Madrid,0.80,0,3,1.50,Barcelona,68253,Estadio Cívitas Metropolitano,José Sánchez,Away Team Wins,3,2.30,-0.80,1.50,-3,3,0,3
30,30,4205635,2024-03-29T20:00:00Z,Cadiz,1.60,1,0,0.50,Granada,15422,Estadio Nuevo Mirandilla,Guillermo Cuadra,Home Team Wins,1,2.10,-0.60,-0.50,1,-1,3,0
30,30,4205637,2024-03-30T13:00:00Z,Getafe,1.60,0,1,0.80,Sevilla,10139,Coliseum Alfonso Pérez,Javier Villanueva,Away Team Wins,1,2.40,-1.60,0.20,-1,1,0,3
30,30,4205633,2024-03-30T15:15:00Z,Almeria,0.80,0,3,1.00,Osasuna,10565,Power Horse Stadium,Pablo González,Away Team Wins,3,1.80,-0.80,2.00,-3,3,0,3
30,30,4205642,2024-03-30T17:30:00Z,Valencia,1.50,0,0,0.90,Mallorca,42567,Estadio de Mestalla,Miguel Ángel Ortiz Arias,Tied Game,0,2.40,-1.50,-0.90,0,0,1,1
30,30,4205634,2024-03-30T20:00:00Z,Barcelona,1.70,1,0,0.30,Las Palmas,46788,Estadi Olímpic Lluís Companys,Mateo Busquets,Home Team Wins,1,2.00,-0.70,-0.30,1,-1,3,0
30,30,4205636,2024-03-31T12:00:00Z,Celta Vigo,0.80,0,0,0.60,Rayo Vallecano,21505,Estadio Abanca Balaídos,Alejandro Hernández,Tied Game,0,1.40,-0.80,-0.60,0,0,1,1
30,30,4205641,2024-03-31T14:15:00Z,Girona,2.60,3,2,0.50,Real Betis,12774,Estadi Municipal de Montilivi,Jesús Gil,Home Team Wins,5,3.10,0.40,1.50,1,-1,3,0
30,30,4205638,2024-03-31T16:30:00Z,Deportivo Alaves,0.30,0,1,0.90,Real Sociedad,18575,Estadio de Mendizorroza,Francisco Hernández,Away Team Wins,1,1.20,-0.30,0.10,-1,1,0,3
30,30,4205639,2024-03-31T19:00:00Z,Real Madrid,1.10,2,0,0.30,Athletic Club,72991,Estadio Santiago Bernabéu,Javier Alberola,Home Team Wins,2,1.40,0.90,-0.30,2,-2,3,0
30,30,4205640,2024-04-01T19:00:00Z,Villarreal,0.80,1,2,1.30,Atletico Madrid,19679,Estadio de la Cerámica,Mario Melero,Away Team Wins,3,2.10,0.20,0.70,-1,1,0,3
26,26,4205599,2024-04-04T18:00:00Z,Granada,0.60,0,1,0.40,Valencia,15107,Estadio Nuevo Los Cármenes,Alejandro Hernández,Away Team Wins,1,1.00,-0.60,0.60,-1,1,0,3
31,31,4205645,2024-04-12T19:00:00Z,Real Betis,1.20,2,1,1.60,Celta Vigo,48938,Estadio Benito Villamarín,Juan Martínez,Home Team Wins,3,2.80,0.80,-0.60,1,-1,3,0
31,31,4205644,2024-04-13T12:00:00Z,Atletico Madrid,2.30,3,1,2.40,Girona,64214,Estadio Cívitas Metropolitano,Ricardo de Burgos,Home Team Wins,4,4.70,0.70,-1.40,2,-2,3,0
31,31,4205651,2024-04-13T14:15:00Z,Rayo Vallecano,1.00,0,0,0.30,Getafe,12868,Estadio del Rayo Vallecano,Jorge Figueroa,Tied Game,0,1.30,-1.00,-0.30,0,0,1,1
31,31,4205646,2024-04-13T16:30:00Z,Mallorca,0.60,0,1,1.50,Real Madrid,23244,Estadi Mallorca Son Moix,José Sánchez,Away Team Wins,1,2.10,-0.60,-0.50,-1,1,0,3
31,31,4205650,2024-04-13T19:00:00Z,Cadiz,1.00,0,1,0.90,Barcelona,19607,Estadio Nuevo Mirandilla,Juan Pulido,Away Team Wins,1,1.90,-1.00,0.10,-1,1,0,3
31,31,4205648,2024-04-14T12:00:00Z,Las Palmas,0.10,0,2,2.10,Sevilla,23698,Estadio de Gran Canaria,Alejandro Muñíz,Away Team Wins,2,2.20,-0.10,-0.10,-2,2,0,3
31,31,4205652,2024-04-14T14:15:00Z,Granada,1.30,2,0,0.30,Deportivo Alaves,13398,Estadio Nuevo Los Cármenes,Víctor García,Home Team Wins,2,1.60,0.70,-0.30,2,-2,3,0
31,31,4205643,2024-04-14T16:30:00Z,Athletic Club,0.70,1,1,2.10,Villarreal,50061,San Mamés,Guillermo Cuadra,Tied Game,2,2.80,0.30,-1.10,0,0,1,1
31,31,4205649,2024-04-14T19:00:00Z,Real Sociedad,1.50,2,2,1.60,Almeria,26520,Reale Arena,Isidro Díaz de Mera,Tied Game,4,3.10,0.50,0.40,0,0,1,1
31,31,4205647,2024-04-15T19:00:00Z,Osasuna,1.90,0,1,0.20,Valencia,19480,Estadio El Sadar,José Luis Munuera,Away Team Wins,1,2.10,-1.90,0.80,-1,1,0,3
32,32,4205654,2024-04-19T19:00:00Z,Athletic Club,1.50,1,1,0.20,Granada,45917,San Mamés,Javier Villanueva,Tied Game,2,1.70,-0.50,0.80,0,0,1,1
32,32,4205655,2024-04-20T12:00:00Z,Celta Vigo,4.00,4,1,1.00,Las Palmas,21256,Estadio Abanca Balaídos,Francisco Hernández,Home Team Wins,5,5.00,0.00,0.00,3,-3,3,0
32,32,4205662,2024-04-20T14:15:00Z,Rayo Vallecano,0.50,2,1,0.50,Osasuna,12617,Estadio del Rayo Vallecano,Mario Melero,Home Team Wins,3,1.00,1.50,0.50,1,-1,3,0
32,32,4205659,2024-04-20T16:30:00Z,Valencia,1.10,1,2,1.30,Real Betis,46371,Estadio de Mestalla,Mateo Busquets,Away Team Wins,3,2.40,-0.10,0.70,-1,1,0,3
32,32,4205660,2024-04-20T19:00:00Z,Girona,2.10,4,1,1.60,Cadiz,12665,Estadi Municipal de Montilivi,Javier Alberola,Home Team Wins,5,3.70,1.90,-0.60,3,-3,3,0
32,32,4205656,2024-04-21T12:00:00Z,Getafe,0.50,1,1,1.20,Real Sociedad,12228,Coliseum Alfonso Pérez,Víctor García,Tied Game,2,1.70,0.50,-0.20,0,0,1,1
32,32,4205653,2024-04-21T14:15:00Z,Almeria,1.80,1,2,1.60,Villarreal,10601,Power Horse Stadium,Miguel Ángel Ortiz Arias,Away Team Wins,3,3.40,-0.80,0.40,-1,1,0,3
32,32,4205657,2024-04-21T16:30:00Z,Deportivo Alaves,0.40,2,0,0.90,Atletico Madrid,18719,Estadio de Mendizorroza,Jesús Gil,Home Team Wins,2,1.30,1.60,-0.90,2,-2,3,0
32,32,4205658,2024-04-21T19:00:00Z,Real Madrid,2.30,3,2,1.40,Barcelona,77981,Estadio Santiago Bernabéu,César Soto,Home Team Wins,5,3.70,0.70,0.60,1,-1,3,0
32,32,4205661,2024-04-22T19:00:00Z,Sevilla,1.10,2,1,0.70,Mallorca,35203,Estadio Ramón Sánchez Pizjuán,Alejandro Hernández,Home Team Wins,3,1.80,0.90,0.30,1,-1,3,0
33,33,4205672,2024-04-26T19:00:00Z,Real Sociedad,0.60,0,1,0.40,Real Madrid,37109,Reale Arena,José Luis Munuera,Away Team Wins,1,1.00,-0.60,0.60,-1,1,0,3
33,33,4205670,2024-04-27T12:00:00Z,Las Palmas,1.60,0,2,1.90,Girona,18734,Estadio de Gran Canaria,Jorge Figueroa,Away Team Wins,2,3.50,-1.60,0.10,-2,2,0,3
33,33,4205663,2024-04-27T14:15:00Z,Almeria,2.40,1,3,1.70,Getafe,7874,Power Horse Stadium,Guillermo Cuadra,Away Team Wins,4,4.10,-1.40,1.30,-2,2,0,3
33,33,4205668,2024-04-27T16:30:00Z,Deportivo Alaves,2.30,3,0,0.20,Celta Vigo,18039,Estadio de Mendizorroza,Juan Pulido,Home Team Wins,3,2.50,0.70,-0.20,3,-3,3,0
33,33,4205669,2024-04-27T19:00:00Z,Atletico Madrid,0.80,3,1,1.00,Athletic Club,64612,Estadio Cívitas Metropolitano,Juan Martínez,Home Team Wins,4,1.80,2.20,0.00,2,-2,3,0
33,33,4205666,2024-04-28T12:00:00Z,Cadiz,0.40,1,1,0.90,Mallorca,18174,Estadio Nuevo Mirandilla,Isidro Díaz de Mera,Tied Game,2,1.30,0.60,0.10,0,0,1,1
33,33,4205667,2024-04-28T14:15:00Z,Granada,2.60,3,0,0.80,Osasuna,13825,Estadio Nuevo Los Cármenes,Alejandro Muñíz,Home Team Wins,3,3.40,0.40,-0.80,3,-3,3,0
33,33,4205671,2024-04-28T16:30:00Z,Villarreal,1.40,3,0,1.00,Rayo Vallecano,17869,Estadio de la Cerámica,Pablo González,Home Team Wins,3,2.40,1.60,-1.00,3,-3,3,0
33,33,4205665,2024-04-28T19:00:00Z,Real Betis,1.80,1,1,1.40,Sevilla,55770,Estadio Benito Villamarín,José Sánchez,Tied Game,2,3.20,-0.80,-0.40,0,0,1,1
33,33,4205664,2024-04-29T19:00:00Z,Barcelona,2.20,4,2,2.10,Valencia,30167,Estadi Olímpic Lluís Companys,Ricardo de Burgos,Home Team Wins,6,4.30,1.80,-0.10,2,-2,3,0
34,34,4205675,2024-05-03T19:00:00Z,Getafe,4.50,0,2,0.60,Athletic Club,12149,Coliseum Alfonso Pérez,Jesús Gil,Away Team Wins,2,5.10,-4.50,1.40,-2,2,0,3
34,34,4205681,2024-05-04T12:00:00Z,Real Sociedad,0.60,2,0,0.50,Las Palmas,29330,Reale Arena,Miguel Ángel Ortiz Arias,Home Team Wins,2,1.10,1.40,-0.50,2,-2,3,0
34,34,4205679,2024-05-04T14:15:00Z,Real Madrid,2.30,3,0,0.90,Cadiz,72654,Estadio Santiago Bernabéu,Javier Villanueva,Home Team Wins,3,3.20,0.70,-0.90,3,-3,3,0
34,34,4205677,2024-05-04T16:30:00Z,Girona,1.80,4,2,2.60,Barcelona,14090,Estadi Municipal de Montilivi,Alejandro Hernández,Home Team Wins,6,4.40,2.20,-0.60,2,-2,3,0
34,34,4205676,2024-05-04T19:00:00Z,Mallorca,0.20,0,1,0.70,Atletico Madrid,20519,Estadi Mallorca Son Moix,Javier Alberola,Away Team Wins,1,0.90,-0.20,0.30,-1,1,0,3
34,34,4205678,2024-05-05T12:00:00Z,Osasuna,0.80,0,2,1.10,Real Betis,18300,Estadio El Sadar,Víctor García,Away Team Wins,2,1.90,-0.80,0.90,-2,2,0,3
34,34,4205673,2024-05-05T14:15:00Z,Celta Vigo,3.90,3,2,0.60,Villarreal,19548,Estadio Abanca Balaídos,César Soto,Home Team Wins,5,4.50,-0.90,1.40,1,-1,3,0
34,34,4205682,2024-05-05T16:30:00Z,Valencia,0.90,0,1,0.80,Deportivo Alaves,44643,Estadio de Mestalla,Mario Melero,Away Team Wins,1,1.70,-0.90,0.20,-1,1,0,3
34,34,4205674,2024-05-05T19:00:00Z,Rayo Vallecano,1.40,0,1,0.40,Almeria,10864,Estadio del Rayo Vallecano,Francisco Hernández,Away Team Wins,1,1.80,-1.40,0.60,-1,1,0,3
34,34,4205680,2024-05-05T19:00:00Z,Sevilla,1.70,3,0,0.40,Granada,32658,Estadio Ramón Sánchez Pizjuán,Mateo Busquets,Home Team Wins,3,2.10,1.30,-0.40,3,-3,3,0
35,35,4205688,2024-05-10T19:00:00Z,Deportivo Alaves,1.70,2,2,1.70,Girona,17906,Estadio de Mendizorroza,José Luis Munuera,Tied Game,4,3.40,0.30,0.30,0,0,1,1
35,35,4205692,2024-05-11T12:00:00Z,Mallorca,0.30,1,0,0.40,Las Palmas,16050,Estadi Mallorca Son Moix,Juan Martínez,Home Team Wins,1,0.70,0.70,-0.40,1,-1,3,0
35,35,4205691,2024-05-11T14:15:00Z,Villarreal,3.10,3,2,1.70,Sevilla,16862,Estadio de la Cerámica,Isidro Díaz de Mera,Home Team Wins,5,4.80,-0.10,0.30,1,-1,3,0
35,35,4205687,2024-05-11T16:30:00Z,Granada,1.00,0,4,1.50,Real Madrid,20058,Estadio Nuevo Los Cármenes,Pablo González,Away Team Wins,4,2.50,-1.00,2.50,-4,4,0,3
35,35,4205683,2024-05-11T19:00:00Z,Athletic Club,1.40,2,2,1.00,Osasuna,45273,San Mamés,José Sánchez,Tied Game,4,2.40,0.60,1.00,0,0,1,1
35,35,4205686,2024-05-12T12:00:00Z,Cadiz,1.50,1,0,0.50,Getafe,16592,Estadio Nuevo Mirandilla,Ricardo de Burgos,Home Team Wins,1,2.00,-0.50,-0.50,1,-1,3,0
35,35,4205684,2024-05-12T14:15:00Z,Atletico Madrid,1.40,1,0,0.40,Celta Vigo,63014,Estadio Cívitas Metropolitano,Jorge Figueroa,Home Team Wins,1,1.80,-0.40,-0.40,1,-1,3,0
35,35,4205690,2024-05-12T16:30:00Z,Valencia,1.30,0,0,0.60,Rayo Vallecano,42642,Estadio de Mestalla,Juan Pulido,Tied Game,0,1.90,-1.30,-0.60,0,0,1,1
35,35,4205689,2024-05-12T19:00:00Z,Real Betis,0.80,3,2,1.20,Almeria,48622,Estadio Benito Villamarín,Alejandro Muñíz,Home Team Wins,5,2.00,2.20,0.80,1,-1,3,0
35,35,4205685,2024-05-13T19:00:00Z,Barcelona,2.10,2,0,0.70,Real Sociedad,35829,Estadi Olímpic Lluís Companys,Guillermo Cuadra,Home Team Wins,2,2.80,-0.10,-0.70,2,-2,3,0
36,36,4205700,2024-05-14T17:30:00Z,Osasuna,0.40,1,1,1.00,Mallorca,17852,Estadio El Sadar,Francisco Hernández,Tied Game,2,1.40,0.60,0.00,0,0,1,1
36,36,4205702,2024-05-14T19:30:00Z,Real Madrid,2.50,5,0,1.30,Deportivo Alaves,68954,Estadio Santiago Bernabéu,Mateo Busquets,Home Team Wins,5,3.80,2.50,-1.30,5,-5,3,0
36,36,4205694,2024-05-14T20:00:00Z,Girona,1.60,0,1,0.60,Villarreal,11440,Estadi Municipal de Montilivi,José Sánchez,Away Team Wins,1,2.20,-1.60,0.40,-1,1,0,3
36,36,4205701,2024-05-15T17:30:00Z,Rayo Vallecano,2.50,2,1,1.20,Granada,12738,Estadio del Rayo Vallecano,Isidro Díaz de Mera,Home Team Wins,3,3.70,-0.50,-0.20,1,-1,3,0
36,36,4205699,2024-05-15T17:30:00Z,Sevilla,1.30,0,1,2.50,Cadiz,35805,Estadio Ramón Sánchez Pizjuán,Miguel Ángel Ortiz Arias,Away Team Wins,1,3.80,-1.30,-1.50,-1,1,0,3
36,36,4205696,2024-05-15T20:00:00Z,Celta Vigo,0.70,2,1,0.20,Athletic Club,21301,Estadio Abanca Balaídos,Víctor García,Home Team Wins,3,0.90,1.30,0.80,1,-1,3,0
36,36,4205697,2024-05-15T20:00:00Z,Getafe,0.60,0,3,1.30,Atletico Madrid,13027,Coliseum Alfonso Pérez,Mario Melero,Away Team Wins,3,1.90,-0.60,1.70,-3,3,0,3
36,36,4205698,2024-05-16T17:30:00Z,Las Palmas,2.30,2,2,1.30,Real Betis,22606,Estadio de Gran Canaria,Javier Villanueva,Tied Game,4,3.60,-0.30,0.70,0,0,1,1
36,36,4205693,2024-05-16T19:30:00Z,Almeria,0.90,0,2,1.60,Barcelona,15543,Power Horse Stadium,Javier Alberola,Away Team Wins,2,2.50,-0.90,0.40,-2,2,0,3
36,36,4205695,2024-05-16T20:00:00Z,Real Sociedad,1.30,1,0,0.80,Valencia,25067,Reale Arena,César Soto,Home Team Wins,1,2.10,-0.30,-0.80,1,-1,3,0
37,37,4205708,2024-05-18T19:00:00Z,Deportivo Alaves,1.20,1,0,0.30,Getafe,18709,Estadio de Mendizorroza,Jorge Figueroa,Home Team Wins,1,1.50,-0.20,-0.30,1,-1,3,0
37,37,4205703,2024-05-19T17:00:00Z,Athletic Club,1.60,2,0,1.80,Sevilla,58401,Estadio Cívitas Metropolitano,Pablo González,Home Team Wins,2,3.40,0.40,-1.80,2,-2,3,0
37,37,4205704,2024-05-19T17:00:00Z,Atletico Madrid,1.60,1,4,0.90,Osasuna,44717,San Mamés,Juan Pulido,Away Team Wins,5,2.50,-0.60,3.10,-3,3,0,3
37,37,4205705,2024-05-19T17:00:00Z,Barcelona,1.70,3,0,0.40,Rayo Vallecano,58036,Estadio Benito Villamarín,Juan Martínez,Home Team Wins,3,2.10,1.30,-0.40,3,-3,3,0
37,37,4205707,2024-05-19T17:00:00Z,Cadiz,1.30,0,0,1.30,Las Palmas,35823,Estadi Olímpic Lluís Companys,Jesús Gil,Tied Game,0,2.60,-1.30,-1.30,0,0,1,1
37,37,4205710,2024-05-19T17:00:00Z,Granada,3.00,1,2,0.40,Celta Vigo,20573,Estadi Mallorca Son Moix,Ricardo de Burgos,Away Team Wins,3,3.40,-2.00,1.60,-1,1,0,3
37,37,4205709,2024-05-19T17:00:00Z,Mallorca,1.90,2,2,1.70,Almeria,11473,Estadio Nuevo Los Cármenes,Javier Alberola,Tied Game,4,3.60,0.10,0.30,0,0,1,1
37,37,4205706,2024-05-19T17:00:00Z,Real Betis,3.20,0,2,2.60,Real Sociedad,36138,Estadio de Mestalla,Guillermo Cuadra,Away Team Wins,2,5.80,-3.20,-0.60,-2,2,0,3
37,37,4205711,2024-05-19T17:00:00Z,Valencia,0.90,1,3,0.60,Girona,18950,Estadio Nuevo Mirandilla,César Soto,Away Team Wins,4,1.50,0.10,2.40,-2,2,0,3
37,37,4205712,2024-05-19T17:00:00Z,Villarreal,1.70,4,4,1.00,Real Madrid,21671,Estadio de la Cerámica,Alejandro Hernández,Tied Game,8,2.70,2.30,3.00,0,0,1,1
38,38,4205716,2024-05-24T19:00:00Z,Girona,4.60,7,0,1.00,Granada,12813,Estadi Municipal de Montilivi,Alejandro Muñíz,Home Team Wins,7,5.60,2.40,-1.00,7,-7,3,0
38,38,4205717,2024-05-25T12:00:00Z,Osasuna,0.90,1,1,1.60,Villarreal,18385,Estadio El Sadar,Mario Melero,Tied Game,2,2.50,0.10,-0.60,0,0,1,1
38,38,4205719,2024-05-25T14:15:00Z,Real Sociedad,0.60,0,2,2.20,Atletico Madrid,30678,Reale Arena,José Sánchez,Away Team Wins,2,2.80,-0.60,-0.20,-2,2,0,3
38,38,4205713,2024-05-25T16:30:00Z,Almeria,2.90,6,1,0.50,Cadiz,7558,Power Horse Stadium,Mateo Busquets,Home Team Wins,7,3.40,3.10,0.50,5,-5,3,0
38,38,4205718,2024-05-25T16:30:00Z,Rayo Vallecano,1.10,0,1,0.90,Athletic Club,13090,Estadio del Rayo Vallecano,José Luis Munuera,Away Team Wins,1,2.00,-1.10,0.10,-1,1,0,3
38,38,4205721,2024-05-25T19:00:00Z,Real Madrid,1.00,0,0,0.70,Real Betis,73614,Estadio Santiago Bernabéu,Isidro Díaz de Mera,Tied Game,0,1.70,-1.00,-0.70,0,0,1,1
38,38,4205715,2024-05-26T12:00:00Z,Getafe,0.90,1,2,1.40,Mallorca,9545,Coliseum Alfonso Pérez,Víctor García,Away Team Wins,3,2.30,0.10,0.60,-1,1,0,3
38,38,4205714,2024-05-26T14:15:00Z,Celta Vigo,1.00,2,2,2.50,Valencia,23043,Estadio de Gran Canaria,Francisco Hernández,Tied Game,4,3.50,1.00,-0.50,0,0,1,1
38,38,4205722,2024-05-26T14:15:00Z,Las Palmas,1.50,1,1,2.00,Deportivo Alaves,21878,Estadio Abanca Balaídos,Miguel Ángel Ortiz Arias,Tied Game,2,3.50,-0.50,-1.00,0,0,1,1
38,38,4205720,2024-05-26T19:05:00Z,Sevilla,1.50,1,2,1.30,Barcelona,34888,Estadio Ramón Sánchez Pizjuán,Javier Villanueva,Away Team Wins,3,2.80,-0.50,0.70,-1,1,0,3